1 1 1 1 1 1 1 1 1 1 1 1 1 1 1 1 1 1 1 1
1 0 1 0 1 0 1 1 0 1 1 0 1 0 0 0 0 0 0 1
1 0 0 0 0 0 0 0 0 0 0 0 0 0 1 0 0 1 0 1
1 0 1 0 1 1 1 1 1 1 0 1 1 0 1 1 0 1 0 1
1 4 1 0 1 1 0 0 0 0 1 1 0 0 1 0 0 1 1 1
1 3 1 0 1 0 0 1 1 0 1 1 0 1 1 1 1 1 1 1
1 0 0 0 1 1 0 1 1 0 0 0 0 1 0 0 0 0 0 1
1 0 1 0 1 1 0 0 0 0 1 1 0 1 0 1 1 1 0 1
1 0 1 0 0 0 0 1 1 1 1 1 0 1 0 1 0 1 0 1
1 1 1 1 0 1 0 1 1 0 0 0 0 1 0 1 0 1 0 1
1 0 0 0 0 1 0 1 1 0 0 1 0 1 0 1 0 1 0 1
1 0 1 1 0 1 0 0 0 0 0 1 0 1 0 1 0 1 0 1
1 0 1 1 0 1 1 1 1 1 0 1 0 1 0 1 0 1 0 1
1 0 1 1 0 0 0 0 0 0 0 1 0 0 0 1 0 0 0 1
1 0 1 1 0 1 0 1 1 1 1 1 0 1 1 0 1 1 1 1
1 0 0 0 0 1 0 1 0 1 0 1 1 1 1 0 1 1 1 1
1 1 1 1 0 1 0 1 0 1 0 0 0 0 1 0 0 0 0 1
1 0 1 1 0 1 0 0 0 0 0 1 1 0 0 0 1 1 0 1
1 0 0 0 0 1 0 1 1 1 0 0 0 1 1 1 1 1 0 1
1 1 1 1 1 1 1 1 1 1 1 1 1 1 1 1 1 1 1 1

8 7 2
14 9 0
5 13 0
